%%%%%%%
%   %G%
%%% % %
% %   %
%S    %
%%%%%%%
